Server	サーバー
character encoding	文字コード
User	ユーザー
Required	必須の	見出しでこの文字列からはじまる場合
Browser	ブラウザ
CP	CP	Craft の管理画面は「CP」と表現されるため、このままにしておく
or later	以降
glutton for punishment	「つらい仕事をいくらでもやる人」「他人がやりたがらないことを進んでやる人」	参考：http://www.eigo-eikaiwa.com/0615.html
ground rules	根本原理
bootstrap	起動
Functions	ファンクション
Locales	ロケール
Settings	設定
Relations	リレーション
Note:	メモ：
public HTML folder	公開ディレクトリ
syntax	構文
param	パラメータ
method	メソッド、手順
column	カラム、列	DB であれば「カラム」、表組みであれば「列」とする
clause	句
controller	コントローラー
Token	トークン
runtime	ランタイム
make sense	意味をなす、筋が通っている
Expiration Date	有効期限日
Entry Types	入力タイプ	エントリーに関する説明では、管理画面の訳文に合わせて「入力タイプ」とする
Author	投稿者	管理画面の訳文に合わせて「投稿者」とする
Title Format	タイトル形式
filters	フィルタ
Conditionals	条件文
fair game	公正なゲーム、かっこうの標的
primary CP nav	CP のメインナビゲーション	管理画面の左側に表示されるナビゲーションのこと
Entry URI Formats	エントリー URI 形式	管理画面の「セクション」画面の表記に合わせる
Category	カテゴリ	管理画面の「設定」画面の表記に合わせる
Entries	エントリ	管理画面のグローバルナビゲーションの表記に合わせる
Matrix	行列	管理画面の表記に合わせる
Global sets	グローバル設定
gear icon	歯車アイコン
e.g.	例：	括弧内で利用されている場合
Examples	実例	見出しなど「名詞」として使われている場合のみ、実例とする
See Also	関連項目
Date/Time Fields	日/時フィールド
Multi-select Fields	マルチセレクトボックスフィールド
{note}	【メモ】
{tip}	【ヒント】
rundown	要約
batch-set	一括設定
Permission	権限	ユーザーに関する場合は「権限」
Permission	パーミッション	サーバー設定に関する場合は「パーミッション」
folksonomies	分類
taxonomies	分類
relational field	関連フィールド
and/or	、および／または、
Criteria	判定基準
Element Criteria Model	Element Criteria Model	「エレメントの判定基準モデル」でも問題ないが、モデル名であることから、このままの表記とする
Beyond that	その他に
starting point	出発点
live	稼働	「Craft が動作する」という文脈の場合
in your templates	テンプレート内で
query builders	クエリビルダー
